11111111111111111111111111111111111111
1000C0000000000000000000000000000C0001
100000000011000C00E00C0001100000000001
10000000001000111111111000100000000001
11111110000001000000000100000001111111
100000000000100000P0000010000000000001
100000000C00000000C00000000C0000000001
10000000001000000000000000100000000001
11000000001000000000000000100000000011
1C0000000100000000C00000000100000000C1
11111111111111111111111111111111111111